03000200400000202024300200402200202200002002042240
02240222022000022022302222223202022044200222002440
02044004004022323232022002042200020044000000030320
42200240020040202420030220044204020023200020203420
20022000002320023020230202200002002223003200002200
20202022023020000040222022000002200420020220202200
22322222022020220222402332220020020402002222220220
23022002000420300002040202222222400200032030322400
40024224402222234200022220200222324022420002022000
22034020220242233222204230002022320222200024420002
03420200020320202202200242220000200003000020200224
00422002020020002202220032200032003440020443002000
20202030000220030200224002342200222034003222200242
00202202200032400022022422442000203023240230222200
24000222434020302020220200002223222042002202200240
20404002200022200240422022402042220002224224020202
42420000420040020400230402004044200300442022200400
23002043222002220044204002020000000224022223222232
30323302240000222300000222202022023002222400322042
40022320022240200300402224020232224322400004020022
20222020202220003400022022222240243242040202220320
04300020222002220223402320402220000202002022000040
22000220200420202003000232202222200040222020222420
02200042300222020204220022300220232234040222222032
00020222042220022202243204220220220202022042222240
00300202302202320330022043220032004220022042002234
03000000200042400200020000202222020224024020000322
22230200000302402200023200240022003040020240423020
23234002424003000042022224033020420040002202402022
20200003030032040340042002002240223322422200000222
00004322004202223234000330200220000222043000240002
22000420340204003222033224340002022022204000020200
42204200002044220422022420222222222202220300222022
22240222022403002403220300224222420020422020224020
30422244022220334220022422024000422422022244020040
30220220330202222242044204002022022200430444032220
00242002224202032324020202420222420200233044003043
00232230330043202040224243404002332220002002243020
20022000022044000000420403000222232002032222200322
40222220232000200030020220220020034240320220020202
22003023222240202030003242020002402200224422022000
22003402000204204200224222030000242042220002040402
00220022032000034043320000222202222204422202000222
44202302243343222200430222402220222202200222023022
20002004000000232002022042240222003040322240002400
22232223203222000022422203002220022004200000444220
20402220003203220202030040200220200042220300232000
22200004200322042000240000224433022022222223024204
23222443002230200202030422442004200200022402404200
30000040420042204200042440202220230242020020202332
